
XXXXX
X H X
X   X
X X X
X   X
  X  
 XXX
  X  
X F X
XXXXX